11111111111111111
10010000000C00001
10C10111001111101
10110101101E01101
10P00101001000101
10111100C11011101
1000000111000C001
11111111111111111
