EA ./textures/EW.xpm
F 252,182,3
WE ./textures/WW.xpm
C 164,231,245
SO ./textures/SW.xpm
NO ./textures/NW.xpm

   11111111111111111   
   10000000000000001   
   10000000000000001   
   1000000000000000111111111111111111111111
   10000000000000000000000000000000000000001
1111000000111100000011111111111111111111111
10000000000010000001   
10000000011110000001   
10000000000000000001   
10000000000000000001   
1000000000000A000001111
10000000000000000000001
11111111111111111111111
