F           502,20,20
C       120,120,0

EA ./textures/EW.xpm
WE ./textures/WW.xpm
SO ./textures/SW.xpm
NO ./textures/NW.xpm

11111111111111111
10000000000000001
10001111111111001
10001000000001001
10001011111101001
1000101E000101001
10001011110101001
10001000000000001
10001111111111101
10000000010000001
11111111111111111
