F 255,0,0
C 0,0,255
EA ./textures/EW.xpm
WE ./textures/WW.xpm
SO ./textures/SW.xpm
NO ./textures/NW.xpm

111111111111111111111111111
100000000000000000000000001
100011111111110011111111111
1000100000000100000001
1000101111110100111111
1111111111111111111111




111111111111111111
1000101N0001010011
100010111100000001
100010000001111111
100011111111 1
100000000001 1
111111111111 1
