F 255,120,0
C 0,120,255
EA ./textures/EW.xpm
WE ./textures/WW.xpm
SO ./textures/SW.xpm
NO ./textures/NW.xpm

11111111111111111
1E00D00D00D00D011
11111111111D11011
111100D000D001011
11111111011001011
11111111011111011
11111111D00D00011
11111111111111111
