F 255,0,0
C 0,0,255
EA ./textures/EW.xpm
WE ./textures/WW.xpm
SO ./textures/SW.xpm
NO ./textures/NW.xpm

         11111111111111111
         10000000000000001
         10001111111111001
         10001000000001001
         10001011111101001
         10001010000101001
         10001011110101001
         10001000001000001
         10001111111111101
         100000000100000N1
         11111111111111111
