F    252,182,3
C 50,50,50
EA ./textures/EW.xpm
WE ./textures/WW.xpm
SO ./textures/SW.xpm
NO ./textures/NW.xpm

          1111111111111111111111
          10000000000000000000001
          1000000000000000000001
111111111111E000000000001001111
1000000000000000111111111111
10001010000101001
10001011110101001
10001000001000001
10000000000000101
10000000010000001
111111111111111111 1
