F           255,120,0
C 0,0,0
EA ./textures/EW.xpm
WE ./textures/WW.xpm
SO ./textures/SW.xpm
NO ./textures/NW.xpm

 11111111111111111
 1N000000000000001
 11000000000000001
 10000000000000001
 10000000000000001
 10000000000000001
 10000000000000001
 10000000000000001
 10000000000000001
 10000000000000001
 11111111111111111
