F 255,38,45
C 0,15,227

NO ./textures/NW.xpm
SO ./textures/SW.xpm
WE ./textures/WW.xpm
EA ./textures/EW.xpm

1111111111111111111
10WD001001001000001
1011000001000001001
1001001001111101111
1001111000001001001
10000D0000000001001
1001111111111001001
1111000000000001011
1000000001000000001
1111111111111111111

