SO ./path_to_the_south_texture
NO ./path_to_the_north_texture
C 25,30,0
WE   ./path_to_the_west_texture
F 220,100,0
EA . /path_to_the_east_texture
   11111111111111111   
   10000000000000001   
   10000000000000001   
   10000000000000001111
   10000000000000000001
11110000001111000000111
10000000000010000001   
10000000011110000001   
10000000000000000001   
10000000000000000001   
1000000000000N000001111
10000000000000000000001
11111111111111111111111
