ola tudo bem



11111111111111111111
10000000000000000001
10000000000000000001
10000000000000000001
10000000000000000001
10000000011110000001
1000000001 000000001
10000000011110000001
10000000000000000001
10000000000000000001
10000000000000000001
10000000000000000001
11111111111111111111
