F 255,0,0
C 0,0,255
EA ./path_to_the_east_texture.xpm
WE ./path_to_the_west_texture.xpm
SO ./path_to_the_south_texture.xpm
NO ./path_to_the_north_texture.xpm

11111111111111111
10000000000000001
10001111111111001
10001000000001001
10001011111101001
1000101E000101001
10001011110101001
10001000001000001
10001111111111101
10000000010000001
11111111111111111
