F 255,0,0
C 0,0,255
EA ./path_to_the_east_texture.xpm
WE ./path_to_the_west_texture.xpm
SO ./path_to_the_south_texture.xpm
NO ./path_to_the_north_texture.xpm

111111111111111111111111111
100000000000000000000000001
100011111111110011111111111
1000100000000100000001
1000101111110100111111
1000101E0001010011
100010111100001001
100010000001111111
100011111111
100000000001
111111111111
